50 50
11111111111111111111111111111111111111111111111111
1                                                1
1                                                1
1                                                1
1                                                1
1                                                1
1                                                1
1                                                1
1                                                1
1                                                1
1                                                1
1                                                1
1                                                1
1                                                1
1                                                1
1                                                1
1                                                1
1                                                1
1         1111111111111111                       1
1         11             1                       1
1        111  2        2 1                       1
1        11              1                       1
1       11     1111111   1                       1
1      11     11     1   1                       1
1     11     11      1   1                       1
1    11     11       1   1                       1
1   11     11        1   1                       1
1   1     11         1   1      1111111111       1
1   1 2  11          1   1      1        1       1
1   1   11           1   1      1 2   2  11      1
1   1   1            1   1      1         11     1
1   1   1            1   1      1   11     11111 1
1   1   1            1   11111111   111        1 1
1   1   1            1              1 11  2  2 1 1
1   1   1            1 2          2 1  11      1 1
1   1   1            1              1   111    1 1
1   1   1            1111111111111111     1    1 1
1   1   1                                 1    1 1
1   1   1                                 1    1 1
1   1   1                                 1    1 1
1   1   1                                 1    1 1
1   1   1                                 1    1 1
1   1   11111111111111111111111111111111111    1 1
1   1                   3                      1 1
1   1 2                 3                    2 1 1
1   1                   3                      1 1
1   11111111111111111111111111111111111111111111 1
1                                                1
1                                                1
11111111111111111111111111111111111111111111111111